1,1,1,1,1
1,3,2,0,1
1,3,0,2,1
1,0,3,3,1
1,1,1,1,1
